1111111111111
1C0N0000001C1
1000011110001
1000000C01011
10C1111101E01
1P00100101011
1111111111111