11111111111111111111111111111111111111111111111111111111111111111
1111110N000000111110000000000000000000000000000000000000000000001
1E0000000N00000C0010000000000000000000000000000000000000000000001
111110C00000P0000C10000000000000000000000000000000000000000000001
11000000000000000010000000000000000000000000000000000000000000001
11100000000000101C10000000000000000000000000000000000000000000001
10100100101010100010000000000000000000000000000000000000000000001
11110010000000101010000000000000000000000000000000000000000000001
10000000000000000010000000000000000000000000000000000000000000001
111100000000N0000010000000000000000000000000000000000000000000001
11111111111111111111111111111111111111111111111111111111111111111